XXXXXXXXXXXXXXXXXXXXXXXXXXXXXXXXXXXXXXXXXXXXXXXXXXXXXXXXXXXXXXXXXXXXXXXXXXXXXXXXXXXXXXXXXXXXXXXXXXXXXXXXXXXXXXXXXXXXXXXXXXXXXXXXXXXXXXXXXXXXXXXXXXXXXXXXXXXXXXXXXXXXXXXXXXXXXXXXXXXXXXXXXXXXXXXXXXXXXXXXXXXXXXXXXXXXXXXXXXXXXXXXXXXXXXXXXXXXXXXX
                                                                                                                                                                                                                                                
                                            Z             Z                     ZZZZZZZZZ            ZZZZZZZZZ                                                  ZZZZZ                ZZ                  ZZ                      C              
                                   Z                                                               ZZ         ZZ             Z                                 ZZZZZZZ               ZZ                  ZZ                     CCC             
                               Z         Z         Z          ZZZZZZZZZZZZZ                      ZZ             ZZ           Z        Z                        ZZZZZZZ                         ZZ                              CCCCC            
                                                                                                       CCCCC                 Z        Z                         ZZZZZ                          ZZ                             CCCCCCC           
                                             Z                                  ZZZZZZZZZ              CCCCC                 Z        Z                                                                                      CCCCCCCCC          
                                                                                  CC CC          ZZ             ZZ           Z                      Z                                  ZZ                                   CCCCCCCCCCC         
                                 Z                            ZZZZZZZZZZZZZ      C  C  C           ZZ         ZZ                           CC       Z                     ZZZ          ZZ             ZZ                   CCCCCCCCCCCCC        
                                       Z               Z                        ZZZZZZZZZ            ZZZZZZZZZ                CCCCCCCCCCCCC         Z                    ZZZZZ                ZZ      ZZ                  CCCCCCCCCCCCCCC       
                                                                                                                                                    Z                     ZZZ                 ZZ                                                
XXXXXXXXXXXXXXXXXXXXXXXXXXXXXXXXXXXXXXXXXXXXXXXXXXXXXXXXXXXXXXXXXXXXXXXXXXXXXXXXXXXXXXXXXXXXXXXXXXXXXXXXXXXXXXXXXXXXXXXXXXXXXXXXXXXXXXXXXXXXXXXXXXXXXXXXXXXXXXXXXXXXXXXXXXXXXXXXXXXXXXXXXXXXXXXXXXXXXXXXXXXXXXXXXXXXXXXXXXXXXXXXXXXXXXXXXXXXXXXX