XXXXXXXXXXXXXXXXXXXXXXXXXXXXXXXXXXXXXXXXXXXXXXXXXXXXXXXXXXXXXXXXXXXXXXXXXXXXXXXXXXXXXXXXXXXXXXXXXXXXXXXXXXXXXXXXXXXXXXXXXXXXXXXXXXXXXXXXXXXXXXXXXXXXXXXXXXXXXXXXXXXXXXXXXXXXXXXXXXXXXXXXXXXXXXXXXXXXXXXXXXXXXXXXXXXXXXXXXXXXXXXXXXXXXXXXXXXXXXXX
                                                                                 Z                                                                                                                                                              
                                                                                 Z             ZZZZZZZZZZZZZZZZZZZZZZ              CCCCC                                ZZZZZZZZ                  Z                                             
                               C                 Z              ZZ      CC       Z                                               CCCC                                     Z                      Z      CCCC             CC            CC       
                                C                Z              ZZ      CC       Z                 CCCCCCCCCCCCCCC             CCC                          C C C         Z               Z      Z      CCCC              CC          CC        
                                                 Z         CC                    Z                 CCCCCCCCCCCCCCC             CC         ZZZZZZ           C C C C                        Z             CCCC               CC        CC         
                                     Z                     CC                    Z                                            CC   ZZZZZZZZ                      C     C     C            Z                                 CC      CC          
                                     Z          CCCC             CC                            ZZZZZZZZZZZZZZZZZZZZZZ        CC   ZZ                        Z     C   C C   C C           Z           Z                      CC    CC           
                                     Z          CCCC             CC   ZZ                                                     CC  ZZ                         Z      C C   C C   C                    Z  ZZZZZZZ                CC  CC            
                                     Z          CCCC                  ZZ                                                        ZZ                          Z       C     C     C                   Z                          CCCC             
                                                                                                                               Z                                                                                                                
XXXXXXXXXXXXXXXXXXXXXXXXXXXXXXXXXXXXXXXXXXXXXXXXXXXXXXXXXXXXXXXXXXXXXXXXXXXXXXXXXXXXXXXXXXXXXXXXXXXXXXXXXXXXXXXXXXXXXXXXXXXXXXXXXXXXXXXXXXXXXXXXXXXXXXXXXXXXXXXXXXXXXXXXXXXXXXXXXXXXXXXXXXXXXXXXXXXXXXXXXXXXXXXXXXXXXXXXXXXXXXXXXXXXXXXXXXXXXXXX